15 15 15 15 15 15 15 15 15 15 15 15 15 15 15 15 15 15 15 15 15
15 06 06 06 06 06 06 06 06 06 06 06 06 06 06 06 06 06 06 06 15
15 06 06 06 06 06 06 06 06 06 06 06 06 06 06 06 06 06 06 06 15
11 11 11 11 04 06 06 06 03 11 11 11 11 11 11 04 06 06 06 06 15
01 01 01 02 05 06 06 06 07 00 01 01 01 01 02 05 06 06 06 06 15
15 06 06 07 05 06 06 06 07 05 06 06 06 06 07 05 06 06 06 06 15
15 06 06 07 05 06 06 06 07 05 06 06 06 06 07 05 06 06 06 06 15
15 06 06 07 05 06 06 06 07 05 06 06 06 06 07 05 06 06 06 06 15
15 06 06 07 05 06 06 06 07 05 06 06 06 06 07 05 06 06 06 06 15
15 06 06 07 10 11 11 11 12 05 06 06 06 06 07 10 11 11 11 11 11
15 06 06 08 01 01 01 01 01 09 06 06 06 06 08 01 01 01 01 01 01
15 06 06 06 06 06 06 06 06 06 06 06 06 06 06 06 06 06 06 06 15
15 06 06 06 06 06 06 06 06 06 06 06 06 06 06 06 06 06 06 06 15
15 15 15 15 15 15 15 15 15 15 15 15 15 15 15 15 15 15 15 15 15